+-+-+-+-+-+-+-+-+-+-+-+-+-+-+-+-+-+-+-+-+-+-+-+-+-+-+-+-+-+-+-+-+-+-+-+-+-+-+-+-+-+-+-+-+-+-+-+-+-+-+-+-+-+-+-+-+-+-+-+-+-+-+-+-+-+-+-+-+-+-+-+-+-+-+-+-+-+-+-+-+-+-+-+-+-+-+-+-+-+-+-+-+-+-+-+-+-+-+-+-+
S |     |       |   |     |   |   |     |   |         |         |         |   |     |     |   |   |       |   |         | |   |     |   |   |             |   |     | |   |     |   |         |   |     |
+ + +-+ + +-+-+ +-+ + +-+ + + + +-+ +-+ +-+ +-+-+-+ + + +-+-+ + +-+-+ +-+ + + + + +-+ + + + + + +-+ +-+-+ + + + +-+-+-+ + + + +-+-+ + + + + + +-+-+-+-+ + + + + +-+ + + + + +-+ + + + +-+-+-+ + + + +-+ +
| | | | |     |   | | | |   | |   | |   |   |       | |   | | |     | |   | |   |     | |   |   |   |     | |   |       | | | |   | | |   | |   |   |   |   |     |   | | |   | | | |       |   |   |   |
+ + + + +-+-+ +-+ + + + +-+-+ +-+ + + +-+ +-+ +-+ +-+-+-+ + + +-+-+ + +-+-+-+-+-+-+-+-+ +-+-+-+ + +-+ +-+-+ +-+ + +-+-+-+ + + + + + + +-+-+ +-+ + + +-+-+-+-+-+-+-+-+ + + +-+ + + + +-+-+-+ +-+-+-+-+ +-+
| | | | |     |   | | |       |     |   |   | |   |   |   | | |   | |   |     |       |   |     |   | |   |   | | |       | | | |     |   |     | |                   | | |   |   |   |   | |       |   |
+ + + + + +-+-+ +-+ + +-+ +-+-+-+-+-+ + +-+ + +-+-+ + + +-+ + + + + +-+ +-+-+ + +-+ + +-+ + +-+-+-+-+ + +-+-+ +-+ + +-+ +-+ + + +-+-+-+ + +-+-+-+ + +-+-+-+-+-+ +-+-+-+-+ + +-+-+ +-+ + + + + +-+ +-+-+ +
| | | | | |     | | |   |   |       | |   |     |   | | |   | | | |     |   | | |   |   | |   |   |           |   | |       | | |   | | |       | |   |   |   | |   |     | |   |   |   |   | | |       |
+ + + + + + +-+-+ + + + +-+ + +-+-+ + +-+-+-+ + + +-+ + + +-+ + + + +-+-+ + + + +-+-+-+ + +-+ + + + + +-+-+-+-+ +-+ +-+ +-+-+-+ + + + + + +-+-+ + +-+-+ + + + + + + + +-+-+ +-+ +-+ +-+-+ +-+ + +-+-+-+-+
|   | |   |           |   |   |     | |       | |   |   |     | | |       | | | |   |   | |   | |   | |     |     |   | | |     | | |   | |   |   |     | | | |   | |   | |   |   | |     |   | |   |   |
+-+-+ +-+-+-+-+-+-+ +-+ +-+-+-+ + +-+ + +-+-+-+ +-+ +-+-+-+-+-+ + +-+ +-+-+ + +-+ + + + + + +-+ +-+-+ + +-+ +-+-+-+-+ + + + +-+-+ + + +-+ + + +-+-+ +-+-+ +-+ +-+-+ +-+ + +-+ +-+ +-+ + +-+-+ + + + +-+ +
|   | |       |   |   |   | |   | |   |   |   | | |       |     |     |       |   |   |   |   |     | |   |         | | | | |     |   |   | | |   | |   | |   |   | |     |     |     | |   | | | |     |
+-+ + + +-+-+ + + +-+ +-+ + + +-+ + +-+-+ + +-+ + +-+-+-+ +-+-+-+-+-+-+ +-+-+-+ +-+-+ +-+-+-+ +-+-+ + +-+-+-+ +-+-+ + + + + +-+-+-+-+-+-+-+ + + + + + + + + +-+ + + + +-+-+-+-+ +-+-+-+-+ + + + + +-+ + +
|   |   |   |   |     |   |   |   |     | |   |   |     |   |     |   | |       |     |     | | |   |     |   |   | | |   |     |       | | | | | | | |   |   | |   | | |     |     |     |   | | |   | |
+ + +-+ + +-+-+-+-+ +-+ +-+ +-+-+-+-+-+ + + + + +-+ + + +-+ + +-+-+ + + + +-+-+-+ +-+-+ +-+ + + + +-+-+-+ + +-+ + + + +-+-+-+-+ + +-+-+ + + + + + + + +-+-+-+ + + +-+ + + +-+ +-+-+ + +-+-+-+ + + +-+-+ +
| |     | |       |   | |   |   |   |   | | | | |   | |   | |       |   | |   |   |       | | |       | | |     | | |     |   | |   |   |   |   | | | |     | | |   | |   |   |     | |   |   |       | |
+ +-+-+-+ + +-+-+ +-+-+ + +-+ + +-+ + +-+ +-+ + + +-+-+-+ + +-+-+ +-+-+-+ + + + +-+-+-+-+ + + +-+ +-+ + + +-+-+-+-+ + +-+ + +-+ +-+ + +-+ +-+-+-+ + + + +-+ + + +-+ + +-+-+ +-+ +-+-+-+ + + +-+-+ + + +-+
|   |   |   |   |       |     |   |   |   |   | | |       |   | | |   |   | | | |   |     | |   | | |   |       |   | |   |     |   | |   |     |   | | |   |   |   | |   |   |         | |     | | |   |
+-+ + + + +-+ + +-+-+-+-+-+-+-+-+ + + + +-+ +-+ + +-+-+-+-+-+ + + + +-+ +-+-+ + +-+ + +-+-+ +-+ + + +-+-+ +-+-+ + +-+ + +-+ +-+-+ +-+ + +-+ + +-+-+ + + + +-+-+-+ +-+ + + + + +-+-+-+-+-+ +-+-+-+ + +-+ +
| |   | | | | |       |   |       | | |   |   | |   |           | | |   |   | |   |   |       | | |     | |   | |   | | |     |   |   | |   |     | |   | |     | | |   | | | | |     |     |   | | |   |
+ +-+-+ + + + +-+-+-+ + + + +-+ +-+-+ +-+ +-+ + +-+ + +-+-+-+-+-+ + + +-+ + + +-+ +-+-+-+-+-+ + + + +-+ + + +-+ +-+ + +-+ +-+ + +-+ +-+ + +-+-+-+ +-+-+-+ +-+-+ + + +-+ +-+ + + + +-+ + +-+-+ + + +-+ +-+
|       |   |   |   |   |   |   |     | |   | | |   |           | |   |   | | | | |   |         | |   |   |     |       | |   | |   |   |   |   |   |     |   |   |   | |   |   |   |     |   |   |   | |
+ +-+-+-+ +-+-+ +-+ +-+-+-+-+ +-+ +-+-+ +-+ + +-+ +-+-+-+ +-+-+ + + +-+ +-+ + + + + + + +-+-+-+-+ +-+ +-+ +-+-+-+ + +-+ + + +-+ + +-+ +-+-+ +-+ +-+ + +-+-+ + + +-+ + + + +-+-+-+-+ +-+ + + +-+-+ + +-+ +
| |     |     |   |   |       |     |   |   |   | |   |   |     |   |   |   | |   | | |   |       |   |   |   |   |   |   |   | |   | |     |   | |   |   | | | | | | |       |   | |   | | |   | | |   |
+ + +-+-+-+ + +-+ +-+ +-+ +-+ + + + + + + +-+-+ + + + + +-+ +-+-+-+-+ +-+ +-+ +-+ +-+ +-+ + +-+-+-+ +-+ +-+ + + +-+-+ +-+-+ + + +-+ + + +-+-+ + + +-+-+ + + +-+ + + +-+-+-+-+ + + + + +-+ + + + + + + +-+
| |   |   | |   |     |   | |   | |   | | |       | | | |   |     |   |     |   |     | | |     |   |   |   | | |   |     | | |   |   | |   | |   |     | | |   |   |   |     | |   | |   | | |   | | | |
+ +-+ + + +-+-+ +-+-+-+ +-+ +-+ + +-+-+-+ +-+-+ +-+ + + + +-+ +-+ + +-+ +-+ +-+ +-+-+ + + +-+-+ + +-+ +-+ +-+ + +-+ +-+-+ + + +-+ +-+-+ + + + +-+-+ +-+-+ + + +-+ + + + + +-+-+ + +-+ + +-+-+ +-+-+ + + +
| |     | |     |     |     |   |         |     |   | | |   |   |   | |   | |   |   | | |     | | |   | |   | | |       | | | | | |   |   |   |     |     | | | | | | |   |   | | | | |       |         |
+ +-+-+-+ + +-+-+ + + +-+-+-+ +-+-+-+-+-+-+ +-+-+ +-+ + +-+ + + +-+-+ +-+ +-+ +-+-+ + + +-+ + + +-+ +-+ +-+ + + + +-+-+ + + + + + + +-+-+-+-+-+ +-+-+-+-+-+ + + + + + +-+-+ + +-+ + + +-+-+-+-+ +-+ +-+-+
|       |   |     | |     | |     |               | | | |   | |       |   |   |   |   |     |     |         | | | |   |   | |   |   |           |   |     |   |   | |   |   | |   |   |         |   |   |
+-+-+-+ + +-+ +-+-+-+-+-+ + +-+-+ + +-+-+-+-+-+ +-+ + + + +-+-+-+ +-+ +-+ + +-+ + +-+-+-+-+-+-+-+ +-+-+-+-+-+ + + + +-+-+-+ +-+-+-+ + + +-+-+-+-+ +-+ +-+ +-+-+-+-+ +-+ + +-+ + +-+-+-+ +-+-+-+-+ +-+ + +
|       |   | |   |   |   | |   |       |     | | |   | |     |   |   |   |   | | |   |         |       |   |   | | |   |   |       | | | |   |     |   |   |       | | | |   | |       |   |   |   | | |
+ +-+-+-+-+ + + +-+ + + +-+ + + +-+-+-+-+ +-+ + + +-+-+ +-+-+ + +-+-+-+ + +-+ +-+ + + + +-+-+-+-+-+-+-+ + +-+-+-+ + + + + +-+ +-+-+-+ + + + + + + + +-+-+ + + +-+-+ + + + +-+-+ + +-+-+-+ + + + + +-+ + +
| |   | |   | |     | |   | | | |   |     | |   |   |   | |     |       | |     | | | |             |   | |   |   |   | |   | |     | | | | | | | |     | | |     | | | |     | | |   |   | | | | |   | |
+ +-+ + + +-+ +-+-+ + +-+ + +-+ + + + +-+-+ +-+-+-+ + +-+ + + +-+-+-+-+ + + +-+ + + +-+-+ +-+-+-+-+ + +-+ + +-+ +-+-+ +-+-+ + + + + + + + + + +-+ +-+ + + + +-+-+ +-+ + +-+-+ + + + + + +-+ + + + + +-+ +
|   | |   |   |     |   | | |   | |             |     |   | |         | |   |   | | |   |     |   |   |   | |   |   |           | | | | | | |       | |   | |     |   | |   | | | | | |   | | | | |   | |
+-+ + + +-+ +-+-+-+ + +-+ + + +-+ +-+-+-+-+-+-+ + +-+-+ +-+ +-+ +-+-+ +-+-+ + +-+ + + + +-+-+ +-+ +-+-+ +-+ + +-+ + +-+-+-+ +-+-+ +-+ + + + +-+-+-+-+ +-+-+-+ +-+-+ + + + + + + + + + +-+-+ + +-+ +-+ + +
| |   | |   |     | | |     | |   |   |   |   |   |   |     |   |   | |   | | |   | | | |       |   |   | |   |   |   |     |       | |   | |   |       |   | |   | |   | |     |   |       |     |   | |
+ +-+ + + +-+ + +-+ +-+ + +-+ + +-+-+ + + + + +-+-+-+ +-+-+-+-+-+ + +-+ + +-+ + +-+ + + +-+-+ + + + + +-+ +-+-+ +-+ + + +-+-+ +-+ + + + +-+ + +-+ +-+ + +-+ + + + + +-+-+ +-+ +-+ +-+-+-+-+-+-+ +-+ +-+ +
|     |   |   |         |     |         |   |         |           |     |         |   |       |   |   |         |   |   |     |   |   |     |     |   |         |         |   |   |                 |   E
+-+-+-+-+-+-+-+-+-+-+-+-+-+-+-+-+-+-+-+-+-+-+-+-+-+-+-+-+-+-+-+-+-+-+-+-+-+-+-+-+-+-+-+-+-+-+-+-+-+-+-+-+-+-+-+-+-+-+-+-+-+-+-+-+-+-+-+-+-+-+-+-+-+-+-+-+-+-+-+-+-+-+-+-+-+-+-+-+-+-+-+-+-+-+-+-+-+-+-+-+
