*************************************************************************************************************************
S *     *     *   *         *   * *       *   *   *               *         *   * *     *   *     *     *       *       *
* * *** * *** *** * ******* *** * * * *** * * * * ********* ***** * ******* * * * * *** * * * * * * *** * ***** * ***** *
* * *   * *   *   *       *       * * *     *   *   *       *   * * *   *   * *   * *   * *   * *   *   *   * *   *   * *
* * * *** * *** ***** *** ********* * * *** ******* * ******* * * * * * *** * *** * * *** ***** *********** * ***** * * *
* * *     * *   *     * * *   *     * *   * *   *   * *       * * * * *     *   * * *     *   *       * *   *       *   *
* * ******* * ********* * *** *********** *** * * ***** *** ***** * * *********** * ******* * ******* * * * *************
* *   *     *     *     *   *     *       *   * * *     *         * *             *   *     * *       *   *       * *   *
* * *** * * ***** * ******* ***** * * *** * *** * ******* * ******* ***************** * ***** * ***************** * * * *
* * *   * *       *       *   *   * * * * * *   * *   * * *   *     *     *     *     * * *   * *           *   * * * * *
* * * ************* ***** *** *** *** * * * * * * * * * * *** * *** * * * * *** * ***** * * *** ***** ***** * * * * * * *
*   * *       *   * *   *   * *   *   * * * * * *   *   * * * * *   * * * * *   *     * *   *     *   *   *   * *     * *
***** * *** * * * * * ***** * * *** *** * * * ******* *** * * * ***** * *** * ******* * ********* * *** * ***** *** *** *
*   *   *   *   *   *         * *   *   *   *   *     * *   *       * *   * *   *     * *   *   *     * * *   *   * *   *
* * ***** ***************** *** * ***** ******* * ***** * ***** *** * *** * *** * * *** * * * * *** * * * * * ***** * * *
* *     * *   *       *   * *   * *     *   *   * *   *   *     *     *   *   *   * *     *   * *   * * * * * *     * * *
******* * * *** ***** *** * * *** * ***** * * *** * * * *** *********** ***** ******* *** ***** ***** * * *** * ***** * *
*     * *   *   *   *   *   * *   *       *   *   * *     *       *     *     *     * *   *         *   *   *   *     * *
* *** * ***** ***** *** * * * * *************** * ******* ******* * ***** ***** *** * * ********* ********* * *** *******
* * * * *   * *     * *   *     *   *   *     * * *     * *       *   *   *   * * *   * *       * *   * *   * *   *     *
* * * * * *** * ***** ******* *** * * * * *** * * * *** * * ********* * *** * * * ***** * ***** * * * * * *** * *** *** *
* *   * * *     *     *     *   * *   * *   * * *   * *   *         *     * *   *       * *     * * *   *   * *     *   *
* * *** * * * *** *** * *** * * ******* *** *** *** * ******* *** ***** * * ******* ******* *** * * * ***** * ******* ***
* *   * *   * * *   * * * *   *   *   * * *     * * *         *   *     *   *   *   *   *     *   * * *   * *   *   *   *
* *** * * *** * * * *** * * ***** *** * * *** *** * *********** *** ******* *** * *** *** ********* * * * * * * * * *** *
* * *   *   * * * *     * * *   *       * * * * *   *         * * *   *   *     *     *   *     *   *   * *   *   *   * *
* * *** * *** * ********* * * * ********* * * * * *** * *** *** * * * *** ************* ***** *** ******************* ***
* * * * * *   * *       *   * *   * *   *     *   *   *   * *   *   *   *   * *         *   *   *       *           *   *
* * * * *** *** * *** ******* *** * * * *********** ***** *** ********* *** * * ********* * *** ******* * ********* *** *
* * *       *   * *   *       * * *   *           *   * *   * *         * * * * *         *   *     *   * *       *     *
* * *** * *** ***** *** *** *** * *** *********** * * * *** * * ********* * * * * ******* *** ***** * *** *** *** *******
*   *   * *   *     *     * *   * *   * *       *   *     *   *       * * *     * * *   * *     *     *     * *     *   *
********* *** * ***** *** *** *** * *** * * *** *** ***************** * * *** *** * * * *** *** * ********* *** ***** * *
*     * *     *   *   *         *   * *   *   * *   *       * *   *   *   *     *   * *   *   *           * *   * *   * *
* *** * ********* ***** ******* ***** ******* * ***** ***** * * *** *** ******* ***** *** *** *** ******* * * *** * *****
*   * * *               *       *   *         *   *     * *         * *           *   *       *     *   *   *   *       *
*** * * * ******* ******* * ***** * ************* * * * * *********** ********* *** ************* * * * ******* *** *** *
*   * * * *     *   * *   * *   * * *             * * *   *       * *     * *   *   *     * *   * * * * * *       *   * *
* *** * * * *** *** * * ***** * * * ********* * * * * ***** ***** * *** * * * * * ******* * * * *** * * * * *********** *
*   *     *   *     *   *     *   *           * *   *       *     *     *     * *         *   *       *                 E
*************************************************************************************************************************
